111111111111111111111111111111
130302303030111110303032030311
101110111110111110111110111011
131110111110111110111110111311
102000032300030300032320000011
131113110111111111110113111311
102002110000011100030112000011
131113111111011101111113111311
101113110444233324440113111011
030002110111111111110112200300
101113110111111111110113111011
131113110333233323330113111311
101113111111011101111113111011
130000110000011100000110000311
101113110111111111110113111011
141112032000303030002322111411
101113111101111111011110111011
141113111100030300011110111411
100300303001111111003032030011
111111111111111111111111111111


111111111111111111111111111111
133332333311333333333333311311
131113111311311131113111311311
131013101311310131013101311311
131113111311311131113111311311
130002033333300020302333300311
111113131111111111303113111111
100013131111111111313113100011
111113131111111111313113100011
103303130313332333313113111111
111113111313111111113113000311
111113133303033333333113111111
111112033311100001113033111111
111113133310000000013131111111
133303133310000000013131111111
131111111311111111113133333311
131111111300332333333131111111
131111111111333331111111111111
133332333333333333333333333311
111111111111111111111111111111


111111111111111111111111111111
133333233333333333333233333311
131111311111011311111311111111
130000303000311303300300000011
131111313111111111311311111111
130000313033323303311300000011
111111313110020011311311111111
130000313100000001311211111111
111111313100000001311311111111
030000303111111111311300000000
131111311300000303303311111111
131111311311111111111311111111
133311300300000303003311000011
111311311311111113113300000011
111311311311111113113111111111
133303311300011303113333233311
131111111111011311111111111311
131111111111011311111111111311
133333333333233233333333333311
111111111111111111111111111111


111111111111111111111111111111
133333331333330000031233330311
131111131311111111131311111311
131303320303000203030300031311
131313131113111113111311131311
133313130003030303000211130311
111313130111131311111311131111
133213330003120213000300120311
131313111113131313111111131311
131303330313130313130000031311
131311111313111113131111131311
131303320313130313130300031311
131113131313131313131311111311
133003131303030303031311000311
131111131313111113131311111311
123333330313000003130300000311
131111111313111113131111111311
133111131313011103131011110311
133333331303031003031333330311
111111111111111111111111111111


111111111111111011111111111111
133333323333330333333333333311
131111111111110111111111111311
131333333233330333323333331311
131311111111110111111111131311
131313333323330333233333131311
131313111111110111111113131311
131313133000000000003313131311
131313131111112111111313131311
131313131000002000001313131311
000000001000000000001000000000
131313131111111111111313131311
131313133000000000003313131311
131313111111110111111113131311
131313333323330333233333131311
131311111111110111111111131311
131333333233330333323333331311
131111111111110111111111111311
133333323333330333333323333311
111111111111110111111111111111