11111111111111111111111111111
13030230303011111030303203031
10111011111011111011111011101
13111011111011111011111011131
10200003230003030003232000001
13111311011111111111011311131
10200211000001110003011200001
13111311111101110111111311131
10111311033323332333011311101
03000211011111111111011220030
10111311011111111111011311101
13111311033323332333011311131
10111311111101110111111311101
13000011000001110000011000031
10111311011111111111011311101
13111203200030303000232211131
10111311110111111101111011101
13111311110003030001111011131
10030030300111111100303203001
11111111111111111111111111111


11111111111111111111111111111
13333333331133333333333331131
13111311131131113111311131131
13111311131131113111311131131
13111311131131113111311131131
13000303333330003030333333331
11311313113111131130311311311
11311313333111133331311311311
11311313111111111131311311311
10330313333333333331311311311
11311311111111111111311333331
11311313330303333333311313131
11331303131110000111303313131
11131313131000000001313113131
13330313131000000001313113131
13111113131111111111313333331
13333333130033000333313111111
13111131111110000111113111111
13333333333333333333333333331
11111111111111111111111111111


11111111111111111111111111111
13333333333333333333333333331
13111131111101131111131111111
13000030300031130330030000001
13111131311111111131131111111
13000031303330330331130000001
11111131311100011131131111111
13000031310000000131131111111
11111131310000000131131111111
03000030311111111131130000000
11111131330000030330331111111
03111131131111111111131100000
13331130030000030300331101111
11131131131111111311330000001
11131131131111111311311111111
13330331130031300311333333331
13111101131111111311111111131
13101101131130011311111111131
13333333333333333333333333331
11111111111111111111111111111


11111111111111111111111111111
13333333133333333333133333031
13111113131111111113131111131
13133003333300000333330003131
13131313111311111311131113131
13331313000303030300031113031
11131313011113131111131113111
13331333000313031300030013031
13131311111313131311111113131
13130333031313031313000003131
13131111131311111313111113131
13130333031313031313030003131
13111313131313131313131111131
13300313130303030303131100031
13111113131311111313131111131
13333333031300000313030000031
13111111131311111313111111131
13311113131301010313101111031
13333333133333333333133333031
11111111111111111111111111111


11111111111111101111111111111
13333333333333033333333333331
13111111111111011111111111131
13133333333333033333333333131
13131111111111011111111113131
13131333333333033333333313131
13131311111111011111111313131
13131313300000000000331313131
13131313111111011111131313131
13131313100000000000131313131
00000000100000000000100000000
13131313111111111111131313131
13131313300000000000331313131
13131311111111011111111313131
13131333333333033333333313131
13131111111111011111111113131
13133333333333033333333333131
13111111111111011111111111131
13333333333333033333333333331
11111111111111011111111111111